.--+--+--+--.
|p      b   |
+  +--+  +  +
|  |     |  |
+  +  +--+--+
|  |    f   |
+  +--+--+  +
|    c   | g|
.--+--+--+--.